10
10
.....#.. .
...#.. . .
....... ...
# ...#....
.#.. ....
... ...# .
 ... .....
...#.. ...
..........
...#.. ...
